{
    "А": "A",
    "В": "B",
    "Ь": "B",
    "С": "C",
    "Е": "E",
    "И": "I",
    "Н": "H",
    "К": "K",
    "М": "M",
    "О": "O",
    "Р": "P",
    "Т": "T",
    "Х": "X",
    "У": "Y",
    "Ч": "4",
    "П": "5",
    "Ш": "W",
    "Д": "2",
    "З": "3"
}